Humans: 5
RRRRRRRRRRRRRRR
R@............R
R.L.L.L.L.L.L.R
R..G.G........R
R.L.L.L.L.L.L.R
R.............R
R.L.L.L.L.L.L.R
R.............R
R.L.L.L.L.L.L.R
R.............R
R.L.L.L.L.L.LLR
R...........LZR
RRRRRRRRRRRRRRR
