RRRRRRRRR
R..E.E..R
R.RRRRR.R
R.......R
RRRRRRRRR