RRRRRRRRR
R.E.....R
R....L..R
R..G....R
R..G....R
R.......R
R.....@.R
R.E.....R
RRRRRRRRR