RRRRRRRRR
R.E.....R
R.......R
R.GGGGG.R
R.....@.R
R.E.....R
RRRRRRRRR