RRRRRRRRRRRRRRR
R.............R
R......GGGGG..R
R......GE..G..R
R......G...G..R
R.....@G.GGG..R
R......G.G....R
R.....EG.G....R
R......G.G....R
R......GGG....R
R.............R
R............ZR
RRRRRRRRRRRRRRR