RRRRRRRRR
R.M.....R
R....L..R
R..GGG..R
R..GGG..R
R..GGG..R
R.....@.R
R.C.....R
RRRRRRRRR