RRRRRRRRRRRRRRR
R.............R
R......G......R
R.....EG......R
R......G......R
R.....@G......R
R......G......R
R.....EGG.....R
R......G......R
R......GG.....R
R......G......R
R............ZR
RRRRRRRRRRRRRRR